10
S.B.-.B.P.B.-.-.-.-
B.S.S.B.P.B.-.-.G.-
-.BS.W.BS.P.B.-.-.-.-
B.P.BS.-.B.-.-.-.-.-
P.B.-.-.-.-.-.-.-.-
B.-.-.-.-.-.B.-.-.-
-.-.-.G.-.B.P.B.-.-
-.-.G.-.-.-.B.G.B.-
-.-.-.-.G.-.-.B.P.B
-.-.-.A.-.-.-.-.B.-