10
-.B.-.-.-.-.-.B.-.-
B.P.B.-.-.-.B.P.B.-
-.BS.-.G.-.-.-.B.-.-
S.W.S.-.-.G.-.-.-.-
-.S.-.-.G.-.S.-.-.-
-.-.-.G.-.BS.W.S.-.-
-.G.-.-.B.P.BS.-.-.-
-.-.-.B.P.B.-.-.-.-
G.-.-.-.B.-.-.-.-.-
-.-.-.-.-.-.-.-.-.-