10
-.-.-.G.G.-.-.-.-.G
-.-.-.G.G.-.B.-.-.-
-.B.-.-.-.B.P.B.-.-
B.P.B.-.-.-.B.-.S.-
-.B.-.-.G.G.-.S.W.S
-.G.-.-.G.G.-.-.S.-
-.-.S.-.-.-.-.B.-.-
-.S.W.S.G.-.B.P.B.-
-.-.S.-.A.-.-.B.-.-
-.-.-.G.-.-.G.-.-.G