10
-.B.-.-.G.-.G.G.-.-
B.P.B.-.S.-.-.-.G.-
-.B.-.S.W.S.-.G.-.-
-.-.-.-.S.-.A.-.-.-
-.G.-.G.B.G.S.G.-.-
B.P.B.B.P.BS.W.S.-.-
-.G.-.G.B.G.S.-.-.-
-.-.G.-.G.-.-.-.-.-
-.G.-.G.-.G.-.G.-.-
-.-.G.-.-.-.-.G.-.-