10
-.-.-.-.-.-.-.-.-.-
-.G.-.-.S.-.-.-.-.-
G.-.-.S.W.S.-.-.-.-
-.-.-.-.S.B.-.-.G.-
-.-.G.-.B.P.B.-.-.-
-.-.-.-.-.B.-.-.-.-
-.-.-.-.G.-.-.-.-.-
-.-.-.B.-.-.S.-.-.-
-.-.B.P.B.S.W.S.-.-
-.-.-.B.-.-.S.-.-.-