10
-.G.-.-.S.-.-.-.-.-
-.G.-.S.W.S.-.B.-.-
-.-.-.-.S.-.B.P.B.-
-.B.-.-.-.-.-.B.-.-
B.P.B.-.-.-.-.G.-.-
-.B.-.-.-.S.-.G.-.-
-.-.-.-.S.W.S.-.-.-
-.-.-.-.-.S.-.-.-.-
-.G.-.-.-.-.-.-.-.-
-.G.-.-.-.-.-.-.-.-