10
G.G.-.B.P.B.-.-.-.-
G.G.S.B.P.B.-.-.G.-
-.BS.W.BS.P.B.-.-.-.-
B.P.BS.-.B.-.-.-.-.-
P.B.-.-.-.-.-.-.-.-
B.-.-.G.-.-.B.-.-.-
-.-.-.G.-.B.P.B.-.-
-.-.G.-.-.-.B.G.B.-
-.-.-.-.-.-.-.B.P.B
-.-.-.-.-.-.-.-.B.-