10
-.G.G.-.S.-.-.-.-.-
-.G.G.S.W.S.-.B.-.-
-.-.G.-.S.-.B.P.B.-
-.B.-.G.G.-.-.B.-.-
B.P.B.G.G.G.-.G.G.-
-.B.-.-.-.S.-.G.-.G
-.-.G.-.S.W.S.-.-.G
-.-.-.-.-.S.-.-.-.G
-.G.G.A.G.G.G.G.G.G
-.G.-.-.-.-.-.-.-.G