10
-.-.-.-.-.-.-.-.-.G
-.-.-.G.-.-.B.-.-.-
-.B.-.-.-.B.P.B.-.-
B.P.B.-.-.-.B.-.S.-
-.B.-.-.G.G.-.S.W.S
-.-.-.-.G.G.-.-.S.-
-.-.S.-.-.-.-.B.-.-
-.S.W.S.-.-.B.P.B.-
-.-.S.-.-.-.-.B.-.-
-.-.-.-.-.-.-.-.-.G