10
-.B.-.-.G.-.-.-.B.-
B.P.B.-.-.-.-.B.P.B
-.B.-.-.G.G.-.-.B.-
G.-.G.-.-.-.-.G.-.-
-.-.-.-.S.S.-.-.-.G
G.-.-.S.W.W.S.-.-.-
-.-.G.-.S.S.-.G.-.-
G.-.-.-.-.-.-.-.B.-
-.-.G.-.G.G.-.B.P.B
-.G.G.-.-.-.-.G.B.-