10
-.B.-.-.-.-.-.-.B.-
B.P.B.-.-.-.-.B.P.B
-.B.-.-.G.G.-.-.B.-
-.-.G.-.-.-.-.G.-.-
-.-.-.-.S.S.-.-.-.-
-.-.-.S.W.W.S.-.-.-
-.-.G.-.S.S.-.G.-.-
-.-.-.-.-.-.-.-.B.-
-.-.-.-.G.G.-.B.P.B
-.-.-.-.-.-.-.-.B.-