10
-.B.-.-.-.-.-.-.-.-
B.P.B.-.S.-.-.-.-.-
-.B.-.S.W.S.-.-.-.-
-.-.-.-.S.-.-.-.-.-
-.G.-.G.B.G.S.G.-.-
B.P.B.B.P.BS.W.S.-.-
-.G.-.G.B.G.S.-.-.-
-.-.-.-.-.-.-.-.-.-
-.-.-.-.-.-.-.-.-.-
-.-.-.-.-.-.-.-.-.-