10
-.S.-.-.-.-.B.-.-.-
S.W.S.-.-.B.P.B.-.-
-.S.-.S.-.-.B.G.-.-
-.-.S.W.S.-.-.-.-.-
-.-.-.S.-.B.-.-.G.-
-.G.-.-.B.P.B.-.-.-
-.-.-.G.-.B.-.-.-.-
-.-.-.-.-.-.-.-.B.-
-.-.-.-.G.-.-.B.P.B
-.-.-.-.-.-.-.-.B.-