10
-.S.-.-.G.-.B.G.G.G
S.W.S.-.-.B.P.B.-.G
-.S.-.S.-.-.B.G.-.G
-.-.S.W.S.-.-.-.-.-
-.-.-.S.-.B.-.A.G.-
-.G.-.-.B.P.B.-.G.-
-.-.G.G.-.B.-.-.-.-
-.-.-.G.-.-.-.-.B.-
-.G.-.-.G.-.-.B.P.B
-.-.-.G.-.G.-.-.B.-