10
-.G.-.G.-.G.-.G.-.-
-.S.-.-.-.-.-.-.S.-
S.W.S.-.G.-.-.S.W.S
-.S.-.-.B.-.-.-.S.-
-.-.G.B.P.B.G.-.-.-
-.-.-.-.B.-.-.B.-.-
-.-.-.-.-.-.B.P.B.-
-.-.-.-.-.-.-.B.-.-
-.-.-.-.-.-.-.-.-.-
-.-.-.-.-.-.-.-.-.-