10
-.G.-.G.-.G.-.G.-.-
-.S.-.G.G.G.-.-.S.-
S.W.S.-.G.-.-.S.W.S
-.S.-.-.B.-.G.-.S.-
-.-.G.B.P.B.G.-.G.-
G.-.-.-.B.-.-.B.-.-
G.G.-.A.-.-.B.P.B.-
G.G.G.-.-.-.G.B.-.-
G.G.-.-.-.G.-.-.G.-
G.G.-.-.G.-.G.-.-.-