10
P.B.-.-.-.-.-.-.B.P
B.-.-.-.-.-.-.-.-.B
-.-.G.-.-.-.-.G.-.-
S.-.-.-.B.-.-.-.-.S
W.S.-.B.P.B.-.-.S.W
S.-.-.-.B.-.-.-.-.S
-.-.-.-.-.-.S.-.G.-
-.-.G.-.-.S.W.S.-.-
-.-.-.-.-.-.S.-.-.B
-.-.-.-.-.-.-.-.B.P