10
P.B.G.G.-.G.-.-.B.P
B.-.G.G.-.G.-.-.-.B
-.G.G.-.-.-.-.G.-.-
S.-.-.-.B.-.G.-.-.S
W.S.G.B.P.B.-.G.S.W
S.G.-.G.B.-.-.-.-.S
-.-.-.G.-.-.S.-.G.-
-.G.G.G.-.S.W.S.-.G
-.-.-.G.-.G.S.-.-.B
-.A.-.G.-.G.-.-.B.P